

     

 F 225,225,250 
    
    NO ./xpm/N.xpm
      
  SO ./xpm/S.xpm
    
    C 120,111,100
      
  WE ./xpm/W.xpm
    
    EA ./xpm/E.xpm
       






        

   111111111111111111111111
  1111111000000010000001111111 
    11111111100000000000001100111 
      11111111000000S0000000111111

       1110000000000000111111111 
       110000001100000011
       11111111111111111111