NO ./xpm/N.xpm
SO ./xpm/S.xpm
WE ./xpm/W.xpm
EA ./xpm/E.xpm

F 220,100,220   
C 225,1,1                


   111111111111111111111
   11111110000000000000111111111
    11111000000N000000000100111
      11110000000000000011111
        11111111111111111