NO ./xpm/N.xpm
SO ./xpm/S.xpm
WE ./xpm/W.xpm
EA ./xpm/E.xpm

F 220,100,220   
C 225,1,1                


   111111111111111111111
   111111100000111111111
    11111011N00100111
      111100100011111
        11111111111