NO ./xpm/NO.xpm
SO ./xpm/NO.xpm
WE ./xpm/NO.xpm
EA ./xpm/NO.xpm

F 220,100,220   
C 225,1,1                


        111111111
        1000001
        1011N001
        10010001
        11111111