NO ./xpm/NO.xpm
SO ./xpm/NO.xpm
WE ./xpm/NO.xpm
EA ./xpm/NO.xpm

F 220,100,         300     
C 225,1,0

        11111111
        10000001
        1011N001
        10010001
        11111111