NO ./xpm/N.xpm
SO ./xpm/S.xpm
WE ./xpm/W.xpm
EA ./xpm/E.xpm

F 220,100,220   
C 225,1,1                


        111111111
        1000001111111
        1011N001001
        1001000111
        11111111