F 120,111,100 
  N ./xpm/N.xpm
SO ./xpm/S.xpm
C 225,225,225 
WE ./xpm/W.xpm
EA ./xpm/E.xpm



               


        111111111111111111111
    11111000000010000001111111
    11111100000000000001100111
      1111000000N000000011111
       111000000000000011
       110000001100000011
       11111111111111111111